    NO    ./config/text/t_n
        SO  ./config/text/t_s     
WE ./config/text/t_w  
   EA  ./config/text/t_e
  
F  22,0,0    
C   225,30,00
    



11111111111
110000001
110000111
110000011
10000111
100N00011
1001100001111
10011110011
1000111100111          
101001100111        
11 1000111
11 10001        
11 10001
11 11111

