NO ./maps/text/t_n
SO ./maps/text/t_s
WE ./maps/text/t_w
EA ./maps/text/t_e

F 220,100,0
C 225,30,0

        11111111111 1111111111111
        1000000000111000000000001
        1011000001110000000000001
        1001000000000000000000001
111111111011000001110000000000001
100000000011000001110111111111111
11110111111111011100000010001
 1110111111111011101010010001
11000000110101011100000010001
10000000000000000000000000001
10000000000000001101010010001
11000001110101011100011010N01
11110111 1110101 101111010001
11111111 1111111 111111111111