NO ./maps/text/t_n
SO ./maps/text/t_s
WE ./maps/text/t_w
EA ./maps/text/t_e

F 56,108,176
C 220,78,65

1111111111111111111111111
100000000000W000000000001
1111111111111111111111111

