EA ./maps/text/bluestone.png
NO ./maps/text/eagle.png
SO ./maps/text/mossy.png
WE ./maps/text/colorstone.png

F 175,195,120
C 128,124,120


        11111111111 1111111111111
        1000000000111000000000001          
        1011000001110000000000001          
        1001000000000000000000001          
111111111011000001110000000000001          
100000000011000001110111111111111          
11110111111111011100000010001              
 1110111111111011101010010001              
11000000110101011100000010001    
1000N000000000000000000000001    
10000000000000001101010000001    
11000001110101011100011000001    
11110111 1110101 101111000001    
11110111 1111111 111111111111    
11110111               
100000111111           
11111111          


