EA ./maps/text/redbrick.png
NO ./maps/text/redbrick.png
SO ./maps/text/mossy.png
WE ./maps/text/colorstone.png

F 0,200,0
C 0,0,200

        11111111111 1111111111111   11
        1000000000111000000000001   11          
        1011000001110000000000001   11          
        1001000000000000000000001   11          
111111111011000001110000000000001   11          
100000000011000001110111111111111   11          
11110111111111011100000010001       11          
 1110111111111011101010010001       11          
11000000110101011100000010001       11
1000S000000000000000000000001       11
10000000000000001101010000001       11
11000001110101011100011000001       11
11110111 1110101 101111000001       11
11110111 1111111 111111111111       11
11110111               
100000111111           
11111111          
       
1111111111111111111111111          


