NO ./maps/text/t_n
SO ./maps/text/t_s
WE ./maps/text/t_w
EA ./maps/text/t_e

F 220,100,0
C 225,30,0

 
11111111
10000001
10000111
100001
10000111
10000001
100N0001
10000001
10000001
10100001
11 10001
11 10001
11 10001
11 11111