NO ./maps/text/t_n
SO ./maps/text/t_s
WE ./maps/text/t_w
EA ./maps/text/t_e

F 56,108,176
C 220,78,65

1111111111111111111111111
1000000000000000000000001
10000000E0000000000000001
1000000000000000000000001
1111111111111111111111111

