NO ./maps/text/greystone.png
SO ./maps/text/mossy.png
WE ./maps/text/colorstone.png
EA ./maps/text/redbrick.png

F 56,108,176
C 220,78,65

1111111111111111111111111
1000000000000000000000001
1000111111000000000000001
1000101010000000000000001
1000000000000000000000001
100000000000000000000W001
1000000000000000000000001
1000101010000000000000001
1000111111000000000000001
1000000000000000000000001
1111111111111111111111111

