NO ./maps/text/greystone.png
SO ./maps/text/mossy.png
WE ./maps/text/colorstone.png
EA ./maps/text/redbrick.png

F 56,108,176
C 220,78,65

11111111111111111111111111111
   1111000000000000000000000111
11110000000W11100000000111111
1000000000111 1000000001111
11111111111   1111111111111

